3 3 3 3 3 3 3 3 3 3 3 3 3 3  
230 25 0 0 0 0 3 0 0 0 0 3 0 0 0  
3 1 1 1 3 2 2 2 2 3 1 1 1 3  
 3 2 2 2 3 1 1 1 3 2 2 2 3  
3 3 3 3 3 3 3 3 3 3 3 3 3 3  
 4 4 4 4 0 0 0 0 0 4 4 4 4  
4 4 4 0 1 2 1 2 1 0 4 4 4 4  
 4 4 0 1 2 3 3 3 2 1 0 4 4  
4 0 1 2 3 4 4 4 3 2 1 0 4 4  
 0 1 2 3 4 4 4 4 3 2 1 0 4  
4 4 4 4 4 4 4 4 4 4 4 4 4 4  
 4 4 4 4 4 4 4 4 4 4 4 4 4  
4 4 4 4 4 4 4 4 4 4 4 4 4 4  
 4 4 4 4 4 4 4 4 4 4 4 4 4  
4 4 4 4 4 4 4 4 4 4 4 4 4 4  
 4 4 4 4 4 4 4 4 4 4 4 4 4  
4 4 4 4 4 4 4 4 4 4 4 4 4 4  