230 20 1 2 1 2 1 2 1 2 1 2 1 2 1 2  
 2 1 2 1 2 1 2 1 2 1 2 1 2  
0 1 0 1 0 1 0 1 0 1 0 1 0 1  
 3 3 3 3 3 3 3 3 3 3 3 3 3  
2 0 2 0 2 0 2 0 2 0 2 0 2 0  
 1 2 1 2 1 2 1 2 1 2 1 2 1  
4 4 4 4 4 3 3 3 3 4 4 4 4 4  
 4 4 4 4 3 0 0 0 3 4 4 4 4  
4 4 4 3 0 1 2 1 0 3 4 4 4 4  
 4 4 3 0 1 2 1 2 1 0 3 4 4  
4 4 4 4 4 4 4 4 4 4 4 4 4 4  
 4 4 4 4 4 4 4 4 4 4 4 4 4  
4 4 4 4 4 4 4 4 4 4 4 4 4 4  
 4 4 4 4 4 4 4 4 4 4 4 4 4  
4 4 4 4 4 4 4 4 4 4 4 4 4 4  
 4 4 4 4 4 4 4 4 4 4 4 4 4  
4 4 4 4 4 4 4 4 4 4 4 4 4 4  